OA,Pop_econ,unempl,student,inactive,sum_no_income,mean_no_income
E00025604,258,11,33,139,183,0.7093023255813954
E00025605,196,35,15,71,121,0.6173469387755102
E00025607,205,19,12,91,122,0.5951219512195122
E00025608,292,22,16,130,168,0.5753424657534246
E00025611,366,37,21,163,221,0.6038251366120219
E00025612,267,22,27,104,153,0.5730337078651685
E00025613,195,26,2,86,114,0.5846153846153846
E00025614,178,18,10,66,94,0.5280898876404494
E00025615,273,23,26,144,193,0.706959706959707
E00025616,138,25,4,47,76,0.5507246376811594
E00025617,350,18,29,169,216,0.6171428571428571
E00025618,228,26,10,94,130,0.5701754385964912
E00025619,197,13,12,88,113,0.5736040609137056
E00025620,243,23,16,128,167,0.6872427983539094
E00025621,214,23,18,93,134,0.6261682242990654
E00025622,185,14,5,66,85,0.4594594594594595
E00025623,305,21,39,131,191,0.6262295081967213
E00025624,237,25,6,108,139,0.5864978902953587
E00025625,235,23,12,107,142,0.6042553191489362
E00025626,203,16,6,106,128,0.6305418719211823
E00025627,246,25,12,112,149,0.6056910569105691
E00025628,233,17,18,91,126,0.5407725321888412
E00025629,212,6,11,110,127,0.5990566037735849
E00025630,278,23,30,124,177,0.6366906474820144
E00025631,254,11,23,109,143,0.562992125984252
E00025632,144,11,6,60,77,0.5347222222222222
E00025633,489,24,107,266,397,0.8118609406952966
E00025634,201,13,11,102,126,0.6268656716417911
E00025635,169,12,10,64,86,0.5088757396449705
E00025636,415,22,48,210,280,0.6746987951807228
E00025638,193,9,6,74,89,0.46113989637305697
E00025639,149,8,9,41,58,0.38926174496644295
E00025640,223,12,8,55,75,0.336322869955157
E00025641,273,9,2,69,80,0.29304029304029305
E00025642,189,9,3,58,70,0.37037037037037035
E00025643,335,16,12,104,132,0.3940298507462687
E00025644,225,15,7,84,106,0.4711111111111111
E00025645,172,7,2,25,34,0.19767441860465115
E00025646,236,5,5,57,67,0.2838983050847458
E00025647,253,20,5,69,94,0.3715415019762846
E00025648,299,22,5,91,118,0.39464882943143814
E00025649,185,6,8,78,92,0.4972972972972973
E00025650,187,10,9,47,66,0.35294117647058826
E00025651,239,21,7,84,112,0.4686192468619247
E00025652,223,19,7,62,88,0.39461883408071746
E00025653,196,13,4,80,97,0.49489795918367346
E00025654,206,23,6,71,100,0.4854368932038835
E00025655,246,17,8,81,106,0.43089430894308944
E00025656,189,12,5,30,47,0.24867724867724866
E00025657,161,10,4,55,69,0.42857142857142855
E00025658,267,8,7,61,76,0.2846441947565543
E00025659,302,16,7,78,101,0.3344370860927152
E00025660,194,6,10,45,61,0.31443298969072164
E00025661,213,9,9,59,77,0.3615023474178404
E00025662,208,10,11,51,72,0.34615384615384615
E00025663,314,17,8,80,105,0.3343949044585987
E00025664,273,9,9,56,74,0.27106227106227104
E00025665,297,11,4,52,67,0.2255892255892256
E00025666,239,4,6,86,96,0.401673640167364
E00025667,218,9,6,48,63,0.2889908256880734
E00025668,203,12,14,74,100,0.49261083743842365
E00025669,184,13,5,85,103,0.5597826086956522
E00025670,221,11,12,66,89,0.40271493212669685
E00025671,199,15,5,78,98,0.49246231155778897
E00025672,218,9,8,82,99,0.4541284403669725
E00025673,235,14,15,78,107,0.4553191489361702
E00025674,219,18,3,73,94,0.4292237442922374
E00025675,193,10,7,67,84,0.43523316062176165
E00025676,229,20,10,72,102,0.44541484716157204
E00025677,188,6,6,85,97,0.5159574468085106
E00025678,275,17,6,88,111,0.4036363636363636
E00025680,269,7,15,29,51,0.1895910780669145
E00025681,180,18,8,74,100,0.5555555555555556
E00025682,223,24,12,88,124,0.5560538116591929
E00025684,245,6,3,111,120,0.4897959183673469
E00025685,259,6,12,16,34,0.13127413127413126
E00025687,213,12,5,60,77,0.3615023474178404
E00025688,205,15,5,63,83,0.40487804878048783
E00025689,226,16,6,85,107,0.47345132743362833
E00025690,196,15,3,58,76,0.3877551020408163
E00025691,298,10,13,31,54,0.18120805369127516
E00025692,252,10,6,55,71,0.28174603174603174
E00025693,279,7,12,67,86,0.30824372759856633
E00025694,242,18,7,83,108,0.4462809917355372
E00025695,204,6,14,30,50,0.24509803921568626
E00025696,251,9,0,56,65,0.2589641434262948
E00025697,296,15,11,60,86,0.2905405405405405
E00025698,216,13,5,63,81,0.375
E00025699,332,9,11,55,75,0.22590361445783133
E00025700,218,13,9,26,48,0.22018348623853212
E00025701,307,6,27,51,84,0.2736156351791531
E00025702,205,10,14,72,96,0.4682926829268293
E00025703,211,8,7,53,68,0.3222748815165877
E00025704,261,12,9,40,61,0.23371647509578544
E00025705,254,5,7,32,44,0.1732283464566929
E00025706,221,8,10,23,41,0.18552036199095023
E00025707,170,17,5,6,28,0.16470588235294117
E00025708,255,17,3,49,69,0.27058823529411763
E00025709,282,9,11,71,91,0.32269503546099293
E00025710,221,12,7,105,124,0.5610859728506787
E00025711,169,12,3,61,76,0.44970414201183434
E00025712,218,14,8,56,78,0.3577981651376147
E00025713,184,18,5,71,94,0.5108695652173914
E00025714,215,18,8,77,103,0.4790697674418605
E00025715,178,1,6,14,21,0.11797752808988764
E00025716,208,10,17,44,71,0.34134615384615385
E00025717,220,17,8,80,105,0.4772727272727273
E00025718,240,23,6,96,125,0.5208333333333334
E00025719,355,5,5,29,39,0.10985915492957747
E00025720,260,12,15,80,107,0.4115384615384615
E00025721,245,17,13,100,130,0.5306122448979592
E00025722,184,11,8,76,95,0.5163043478260869
E00025723,201,19,12,74,105,0.5223880597014925
E00025724,240,6,11,74,91,0.37916666666666665
E00025725,408,33,14,105,152,0.37254901960784315
E00025726,241,28,5,92,125,0.5186721991701245
E00025727,137,12,2,68,82,0.5985401459854015
E00025728,252,25,9,71,105,0.4166666666666667
E00025729,220,14,8,97,119,0.5409090909090909
E00025730,223,19,7,107,133,0.5964125560538116
E00025731,223,18,8,81,107,0.4798206278026906
E00025732,247,21,4,74,99,0.4008097165991903
E00025733,347,27,15,77,119,0.34293948126801155
E00025734,255,21,8,100,129,0.5058823529411764
E00025735,287,22,7,110,139,0.4843205574912892
E00025736,347,32,8,121,161,0.46397694524495675
E00025737,251,14,4,117,135,0.5378486055776892
E00025738,240,20,9,88,117,0.4875
E00025739,276,24,4,121,149,0.5398550724637681
E00025740,252,19,6,97,122,0.48412698412698413
E00025741,268,30,9,108,147,0.5485074626865671
E00025742,230,25,6,92,123,0.5347826086956522
E00025743,217,23,4,92,119,0.5483870967741935
E00025744,218,17,4,85,106,0.48623853211009177
E00025745,329,28,17,107,152,0.46200607902735563
E00025746,177,27,3,80,110,0.6214689265536724
E00025747,233,24,6,83,113,0.48497854077253216
E00025748,261,23,7,127,157,0.6015325670498084
E00025749,222,23,8,95,126,0.5675675675675675
E00025750,201,27,5,81,113,0.5621890547263682
E00025751,200,19,10,91,120,0.6
E00025752,178,13,9,69,91,0.5112359550561798
E00025753,229,19,6,101,126,0.5502183406113537
E00025754,222,24,5,92,121,0.545045045045045
E00025756,153,18,6,70,94,0.6143790849673203
E00025757,155,20,3,69,92,0.5935483870967742
E00025758,261,20,15,97,132,0.5057471264367817
E00025759,237,18,7,89,114,0.4810126582278481
E00025760,246,22,15,104,141,0.573170731707317
E00025761,221,28,11,93,132,0.5972850678733032
E00025762,185,18,7,63,88,0.4756756756756757
E00025763,218,21,5,109,135,0.6192660550458715
E00025764,241,18,11,91,120,0.4979253112033195
E00025765,242,12,12,99,123,0.5082644628099173
E00025766,198,20,4,81,105,0.5303030303030303
E00025767,211,21,8,64,93,0.44075829383886256
E00025768,243,13,5,102,120,0.49382716049382713
E00025769,198,16,4,94,114,0.5757575757575758
E00025771,177,24,7,83,114,0.6440677966101694
E00025772,145,19,1,82,102,0.7034482758620689
E00025773,239,27,17,101,145,0.606694560669456
E00025774,210,15,6,78,99,0.4714285714285714
E00025775,162,17,3,71,91,0.5617283950617284
E00025776,228,18,12,105,135,0.5921052631578947
E00025777,275,23,8,110,141,0.5127272727272727
E00025778,257,15,5,98,118,0.4591439688715953
E00025779,194,22,6,84,112,0.5773195876288659
E00025780,84,3,2,35,40,0.47619047619047616
E00025781,187,19,12,75,106,0.5668449197860963
E00025782,180,12,5,83,100,0.5555555555555556
E00025786,218,18,6,83,107,0.4908256880733945
E00025787,225,21,6,115,142,0.6311111111111111
E00025788,298,23,16,144,183,0.6140939597315436
E00025790,240,20,8,112,140,0.5833333333333334
E00025791,216,18,9,90,117,0.5416666666666666
E00025793,205,18,8,98,124,0.6048780487804878
E00025794,211,24,9,94,127,0.6018957345971564
E00025795,230,10,7,102,119,0.5173913043478261
E00025796,238,12,7,112,131,0.5504201680672269
E00025797,194,23,6,83,112,0.5773195876288659
E00025798,229,15,6,97,118,0.5152838427947598
E00025799,271,26,12,121,159,0.5867158671586716
E00025800,263,22,14,91,127,0.4828897338403042
E00025801,241,15,8,124,147,0.6099585062240664
E00025802,202,14,6,54,74,0.36633663366336633
E00025803,209,6,8,59,73,0.3492822966507177
E00025804,159,12,2,57,71,0.44654088050314467
E00025805,113,6,2,67,75,0.6637168141592921
E00025806,196,6,8,88,102,0.5204081632653061
E00025807,238,12,8,81,101,0.42436974789915966
E00025808,199,8,5,57,70,0.35175879396984927
E00025809,237,20,13,102,135,0.569620253164557
E00025810,173,17,6,54,77,0.44508670520231214
E00025811,204,9,8,67,84,0.4117647058823529
E00025812,184,8,8,39,55,0.29891304347826086
E00025813,255,19,9,97,125,0.49019607843137253
E00025814,251,17,9,75,101,0.40239043824701193
E00025815,176,13,3,75,91,0.5170454545454546
E00025816,227,13,7,68,88,0.3876651982378855
E00025817,234,8,2,81,91,0.3888888888888889
E00025818,218,21,7,81,109,0.5
E00025819,252,19,9,96,124,0.49206349206349204
E00025820,226,18,2,88,108,0.4778761061946903
E00025821,197,15,5,87,107,0.5431472081218274
E00025822,207,21,6,79,106,0.5120772946859904
E00025823,222,30,9,80,119,0.536036036036036
E00025825,241,9,5,76,90,0.37344398340248963
E00025826,200,11,3,101,115,0.575
E00025827,206,19,5,61,85,0.41262135922330095
E00025828,199,14,4,79,97,0.48743718592964824
E00025829,150,7,6,75,88,0.5866666666666667
E00025830,211,26,10,80,116,0.5497630331753555
E00025832,343,25,19,110,154,0.4489795918367347
E00025833,211,27,9,89,125,0.5924170616113744
E00025834,261,25,10,74,109,0.41762452107279696
E00025835,285,17,17,123,157,0.5508771929824562
E00025836,312,20,26,127,173,0.5544871794871795
E00025837,350,48,18,106,172,0.49142857142857144
E00025838,232,11,4,85,100,0.43103448275862066
E00025840,187,12,3,83,98,0.5240641711229946
E00025841,250,19,10,89,118,0.472
E00025842,247,13,22,94,129,0.5222672064777328
E00025843,298,24,10,126,160,0.5369127516778524
E00025844,265,31,6,129,166,0.6264150943396226
E00025845,243,19,13,120,152,0.6255144032921811
E00025846,204,18,13,80,111,0.5441176470588235
E00025850,187,15,14,86,115,0.6149732620320856
E00025851,224,14,11,79,104,0.4642857142857143
E00025852,205,12,12,84,108,0.526829268292683
E00025853,244,17,10,52,79,0.3237704918032787
E00025855,175,13,5,64,82,0.4685714285714286
E00025856,207,11,12,59,82,0.3961352657004831
E00025857,445,24,19,161,204,0.4584269662921348
E00025858,219,24,12,100,136,0.6210045662100456
E00025859,226,24,17,96,137,0.6061946902654868
E00025862,206,5,4,53,62,0.30097087378640774
E00025863,166,0,4,35,39,0.23493975903614459
E00025864,203,13,11,70,94,0.4630541871921182
E00025865,243,11,1,83,95,0.39094650205761317
E00025866,168,12,4,44,60,0.35714285714285715
E00025867,183,21,7,44,72,0.39344262295081966
E00025868,189,14,6,73,93,0.49206349206349204
E00025869,261,7,13,76,96,0.367816091954023
E00025870,206,23,9,71,103,0.5
E00025871,169,8,2,55,65,0.38461538461538464
E00025872,143,16,1,67,84,0.5874125874125874
E00025873,225,14,5,75,94,0.4177777777777778
E00025875,209,9,6,51,66,0.3157894736842105
E00025876,207,12,6,42,60,0.2898550724637681
E00025877,206,10,2,66,78,0.3786407766990291
E00025878,142,6,1,64,71,0.5
E00025879,223,8,5,76,89,0.3991031390134529
E00025880,209,18,3,71,92,0.44019138755980863
E00025882,204,13,7,75,95,0.46568627450980393
E00025883,133,21,1,41,63,0.47368421052631576
E00025884,242,11,9,61,81,0.3347107438016529
E00025885,200,7,3,60,70,0.35
E00025886,220,19,6,69,94,0.42727272727272725
E00025887,210,7,6,76,89,0.4238095238095238
E00025888,222,18,2,84,104,0.46846846846846846
E00025889,219,14,14,73,101,0.4611872146118721
E00025890,202,15,7,73,95,0.47029702970297027
E00025891,226,8,8,90,106,0.4690265486725664
E00025892,165,18,7,42,67,0.40606060606060607
E00025893,174,12,6,48,66,0.3793103448275862
E00025894,195,19,4,80,103,0.5282051282051282
E00025895,254,15,12,83,110,0.4330708661417323
E00025896,307,20,15,106,141,0.4592833876221498
E00025897,211,20,1,62,83,0.3933649289099526
E00025898,195,24,6,65,95,0.48717948717948717
E00025899,220,11,4,65,80,0.36363636363636365
E00025900,205,18,8,66,92,0.44878048780487806
E00025901,228,17,8,63,88,0.38596491228070173
E00025902,225,10,7,93,110,0.4888888888888889
E00025903,176,14,4,76,94,0.5340909090909091
E00025904,249,22,9,93,124,0.4979919678714859
E00025905,259,16,9,71,96,0.37065637065637064
E00025906,221,20,7,79,106,0.4796380090497738
E00025907,244,19,12,90,121,0.4959016393442623
E00025908,307,16,7,76,99,0.32247557003257327
E00025909,266,18,10,106,134,0.5037593984962406
E00025910,175,10,3,81,94,0.5371428571428571
E00025911,239,16,16,88,120,0.502092050209205
E00025912,219,17,14,77,108,0.4931506849315068
E00025913,258,21,10,97,128,0.49612403100775193
E00025914,276,23,16,117,156,0.5652173913043478
E00025915,228,15,14,84,113,0.4956140350877193
E00025916,223,17,13,85,115,0.515695067264574
E00025917,242,17,9,83,109,0.45041322314049587
E00025918,219,17,10,81,108,0.4931506849315068
E00025919,234,18,6,95,119,0.5085470085470085
E00025920,219,12,10,71,93,0.4246575342465753
E00025921,224,17,11,79,107,0.47767857142857145
E00025922,221,17,10,90,117,0.5294117647058824
E00025923,295,22,7,80,109,0.3694915254237288
E00025924,261,19,10,106,135,0.5172413793103449
E00025925,374,10,14,87,111,0.2967914438502674
E00025926,275,16,12,55,83,0.3018181818181818
E00025927,251,15,17,69,101,0.40239043824701193
E00025928,265,7,7,74,88,0.3320754716981132
E00025929,302,18,15,97,130,0.4304635761589404
E00025930,236,9,9,88,106,0.4491525423728814
E00025931,314,9,24,104,137,0.43630573248407645
E00025932,258,17,16,68,101,0.39147286821705424
E00025933,216,6,6,71,83,0.38425925925925924
E00025934,246,30,6,86,122,0.4959349593495935
E00025935,281,8,6,102,116,0.4128113879003559
E00025936,234,8,9,66,83,0.3547008547008547
E00025937,298,13,19,114,146,0.4899328859060403
E00025938,228,19,7,88,114,0.5
E00025939,222,23,15,65,103,0.46396396396396394
E00025940,204,15,4,88,107,0.5245098039215687
E00025941,224,18,12,77,107,0.47767857142857145
E00025942,225,13,11,105,129,0.5733333333333334
E00025943,227,15,14,99,128,0.5638766519823789
E00025944,159,10,8,68,86,0.5408805031446541
E00025945,209,18,5,86,109,0.5215311004784688
E00025948,198,25,8,95,128,0.6464646464646465
E00025949,174,8,10,73,91,0.5229885057471264
E00025950,130,15,3,64,82,0.6307692307692307
E00025951,144,6,3,47,56,0.3888888888888889
E00025952,126,13,3,56,72,0.5714285714285714
E00025953,159,12,8,85,105,0.660377358490566
E00025954,182,24,5,88,117,0.6428571428571429
E00025955,189,11,3,98,112,0.5925925925925926
E00025957,144,11,2,77,90,0.625
E00025958,152,13,16,51,80,0.5263157894736842
E00025959,167,7,6,81,94,0.562874251497006
E00025961,138,12,11,52,75,0.5434782608695652
E00025962,169,9,3,82,94,0.5562130177514792
E00025963,226,19,6,62,87,0.38495575221238937
E00025964,176,16,6,78,100,0.5681818181818182
E00025968,186,17,11,77,105,0.5645161290322581
E00025969,159,5,0,80,85,0.5345911949685535
E00025970,162,13,7,69,89,0.5493827160493827
E00025976,138,12,1,78,91,0.6594202898550725
E00025987,281,8,16,82,106,0.37722419928825623
E00025988,246,5,35,92,132,0.5365853658536586
E00025989,141,18,5,41,64,0.45390070921985815
E00025993,156,15,3,63,81,0.5192307692307693
E00025994,94,14,5,37,56,0.5957446808510638
E00025995,162,13,5,72,90,0.5555555555555556
E00025996,240,16,6,69,91,0.37916666666666665
E00025997,202,13,9,84,106,0.5247524752475248
E00025998,285,14,7,71,92,0.32280701754385965
E00026000,223,13,7,95,115,0.515695067264574
E00026001,272,18,10,71,99,0.3639705882352941
E00026002,164,19,1,82,102,0.6219512195121951
E00026003,213,16,12,87,115,0.539906103286385
E00026004,206,15,7,65,87,0.4223300970873786
E00026005,204,7,7,61,75,0.36764705882352944
E00026006,226,4,7,99,110,0.48672566371681414
E00026007,308,22,13,96,131,0.4253246753246753
E00026008,198,25,10,95,130,0.6565656565656566
E00026009,206,23,6,78,107,0.5194174757281553
E00026010,154,13,5,62,80,0.5194805194805194
E00026011,192,5,1,68,74,0.3854166666666667
E00026012,196,8,4,77,89,0.45408163265306123
E00026014,247,29,5,120,154,0.6234817813765182
E00026015,203,11,3,85,99,0.4876847290640394
E00026017,249,23,6,84,113,0.4538152610441767
E00026018,237,10,6,70,86,0.3628691983122363
E00026019,171,16,1,84,101,0.5906432748538012
E00026020,227,20,4,93,117,0.5154185022026432
E00026021,163,29,8,71,108,0.6625766871165644
E00026022,242,13,5,68,86,0.35537190082644626
E00026023,160,12,9,50,71,0.44375
E00026024,185,5,4,82,91,0.4918918918918919
E00026025,210,14,3,107,124,0.5904761904761905
E00026026,174,8,6,86,100,0.5747126436781609
E00026027,292,14,9,94,117,0.4006849315068493
E00026028,245,23,10,108,141,0.5755102040816327
E00026030,244,19,11,110,140,0.5737704918032787
E00026031,232,16,10,89,115,0.4956896551724138
E00026032,225,16,7,66,89,0.39555555555555555
E00026033,219,22,5,105,132,0.6027397260273972
E00026034,250,14,4,121,139,0.556
E00026035,276,11,8,88,107,0.38768115942028986
E00026036,344,32,29,150,211,0.6133720930232558
E00026038,317,19,29,140,188,0.5930599369085173
E00026039,266,17,17,125,159,0.5977443609022557
E00026040,238,20,14,116,150,0.6302521008403361
E00026041,185,19,9,83,111,0.6
E00026042,365,22,30,177,229,0.6273972602739726
E00026043,333,14,33,139,186,0.5585585585585585
E00026045,306,22,19,139,180,0.5882352941176471
E00026046,368,37,37,152,226,0.6141304347826086
E00026047,252,16,15,135,166,0.6587301587301587
E00026048,285,19,14,147,180,0.631578947368421
E00026049,313,15,31,141,187,0.597444089456869
E00026052,271,22,15,94,131,0.4833948339483395
E00026053,257,27,8,100,135,0.5252918287937743
E00026054,294,22,23,143,188,0.6394557823129252
E00026055,150,15,3,72,90,0.6
E00026056,311,25,24,153,202,0.6495176848874598
E00026057,350,23,15,106,144,0.4114285714285714
E00026058,347,31,37,157,225,0.6484149855907781
E00026059,224,22,7,114,143,0.6383928571428571
E00026060,287,31,9,139,179,0.6236933797909407
E00026065,281,16,22,130,168,0.597864768683274
E00026066,249,17,18,123,158,0.6345381526104418
E00026067,292,32,19,130,181,0.6198630136986302
E00026068,227,16,10,105,131,0.5770925110132159
E00026069,316,13,33,149,195,0.6170886075949367
E00026070,299,24,27,146,197,0.6588628762541806
E00026071,233,22,18,111,151,0.648068669527897
E00026072,360,16,38,183,237,0.6583333333333333
E00026073,261,28,15,123,166,0.6360153256704981
E00026075,226,8,7,49,64,0.2831858407079646
E00026076,219,3,3,52,58,0.2648401826484018
E00026077,238,6,8,45,59,0.24789915966386555
E00026078,236,4,1,31,36,0.15254237288135594
E00026079,240,2,2,28,32,0.13333333333333333
E00026080,210,2,8,27,37,0.1761904761904762
E00026081,198,5,7,39,51,0.25757575757575757
E00026082,214,7,6,35,48,0.22429906542056074
E00026083,206,3,4,38,45,0.21844660194174756
E00026084,223,2,3,36,41,0.18385650224215247
E00026085,154,2,4,30,36,0.23376623376623376
E00026086,204,2,7,41,50,0.24509803921568626
E00026087,298,13,13,56,82,0.2751677852348993
E00026088,242,3,5,35,43,0.17768595041322313
E00026089,227,1,6,40,47,0.20704845814977973
E00026090,284,12,7,47,66,0.2323943661971831
E00026091,273,5,2,62,69,0.25274725274725274
E00026092,150,3,2,66,71,0.47333333333333333
E00026093,223,4,5,71,80,0.35874439461883406
E00026094,223,3,6,46,55,0.24663677130044842
E00026095,227,14,5,63,82,0.36123348017621143
E00026096,213,15,6,76,97,0.45539906103286387
E00026097,249,5,8,52,65,0.26104417670682734
E00026098,244,9,3,34,46,0.1885245901639344
E00026099,215,8,2,64,74,0.34418604651162793
E00026100,345,12,17,37,66,0.19130434782608696
E00026101,218,9,7,64,80,0.3669724770642202
E00026102,236,3,3,39,45,0.1906779661016949
E00026103,208,7,6,35,48,0.23076923076923078
E00026104,219,7,8,41,56,0.2557077625570776
E00026105,217,4,6,32,42,0.1935483870967742
E00026106,196,2,2,36,40,0.20408163265306123
E00026107,241,7,7,44,58,0.24066390041493776
E00026108,140,7,4,66,77,0.55
E00026109,330,11,12,50,73,0.22121212121212122
E00026110,210,14,3,79,96,0.45714285714285713
E00026111,175,3,7,37,47,0.26857142857142857
E00026112,314,2,10,39,51,0.1624203821656051
E00026113,337,13,8,42,63,0.18694362017804153
E00026114,326,11,11,39,61,0.18711656441717792
E00026115,248,4,4,51,59,0.23790322580645162
E00026116,144,4,3,33,40,0.2777777777777778
E00026117,170,5,8,35,48,0.2823529411764706
E00026118,234,10,5,47,62,0.26495726495726496
E00026119,234,4,13,32,49,0.2094017094017094
E00026120,254,5,4,44,53,0.20866141732283464
E00026121,287,13,10,52,75,0.2613240418118467
E00026122,200,3,8,40,51,0.255
E00026123,269,7,7,49,63,0.2342007434944238
E00026124,268,3,6,28,37,0.13805970149253732
E00026125,262,5,6,28,39,0.14885496183206107
E00026126,230,11,5,47,63,0.27391304347826084
E00026127,267,10,13,65,88,0.3295880149812734
E00026128,283,34,14,107,155,0.5477031802120141
E00026129,276,26,5,101,132,0.4782608695652174
E00026130,247,14,10,106,130,0.5263157894736842
E00026131,225,7,4,52,63,0.28
E00026132,279,27,7,103,137,0.4910394265232975
E00026133,199,8,4,50,62,0.31155778894472363
E00026134,211,13,11,67,91,0.4312796208530806
E00026136,325,19,9,109,137,0.42153846153846153
E00026137,335,14,11,104,129,0.3850746268656716
E00026138,96,9,0,45,54,0.5625
E00026139,223,9,11,88,108,0.484304932735426
E00026140,247,8,5,81,94,0.3805668016194332
E00026141,186,7,4,68,79,0.42473118279569894
E00026142,164,9,8,71,88,0.5365853658536586
E00026143,216,10,7,82,99,0.4583333333333333
E00026144,243,14,9,74,97,0.3991769547325103
E00026145,188,19,2,80,101,0.5372340425531915
E00026146,203,16,2,65,83,0.4088669950738916
E00026147,326,14,22,118,154,0.4723926380368098
E00026148,189,11,9,72,92,0.48677248677248675
E00026149,236,12,6,72,90,0.3813559322033898
E00026150,239,15,12,101,128,0.5355648535564853
E00026151,288,11,8,94,113,0.3923611111111111
E00026152,220,11,10,89,110,0.5
E00026153,274,23,11,106,140,0.5109489051094891
E00026154,227,12,3,100,115,0.5066079295154186
E00026155,281,14,11,90,115,0.4092526690391459
E00026156,122,7,2,60,69,0.5655737704918032
E00026157,203,21,4,83,108,0.5320197044334976
E00026158,294,25,13,115,153,0.5204081632653061
E00026159,323,22,21,109,152,0.47058823529411764
E00026160,258,23,19,97,139,0.5387596899224806
E00026161,258,19,17,86,122,0.4728682170542636
E00026162,258,16,11,125,152,0.5891472868217055
E00026163,264,16,15,106,137,0.5189393939393939
E00026164,382,32,22,160,214,0.5602094240837696
E00026165,245,10,15,128,153,0.6244897959183674
E00026166,155,12,7,69,88,0.567741935483871
E00026167,303,15,13,133,161,0.5313531353135313
E00026168,231,8,9,66,83,0.3593073593073593
E00026169,206,6,7,40,53,0.25728155339805825
E00026170,235,6,4,46,56,0.23829787234042554
E00026171,251,7,3,49,59,0.2350597609561753
E00026172,274,6,6,35,47,0.17153284671532848
E00026173,240,8,3,90,101,0.42083333333333334
E00026174,153,2,3,29,34,0.2222222222222222
E00026175,181,11,5,56,72,0.39779005524861877
E00026176,214,15,10,66,91,0.4252336448598131
E00026177,247,1,23,51,75,0.30364372469635625
E00026178,235,3,8,49,60,0.2553191489361702
E00026179,199,8,4,58,70,0.35175879396984927
E00026180,179,1,3,34,38,0.2122905027932961
E00026181,237,1,14,66,81,0.34177215189873417
E00026182,210,6,4,83,93,0.44285714285714284
E00026183,319,5,9,75,89,0.27899686520376177
E00026184,186,6,4,46,56,0.3010752688172043
E00026185,269,5,9,65,79,0.2936802973977695
E00026186,264,8,13,65,86,0.32575757575757575
E00026187,311,16,9,44,69,0.22186495176848875
E00026188,254,3,9,51,63,0.24803149606299213
E00026189,274,4,14,67,85,0.3102189781021898
E00026190,246,8,4,49,61,0.24796747967479674
E00026191,180,3,6,38,47,0.2611111111111111
E00026192,254,8,8,45,61,0.24015748031496062
E00026193,220,5,7,32,44,0.2
E00026194,300,3,12,37,52,0.17333333333333334
E00026195,216,5,2,32,39,0.18055555555555555
E00026196,190,2,4,47,53,0.2789473684210526
E00026197,190,6,6,48,60,0.3157894736842105
E00026198,289,10,5,47,62,0.21453287197231835
E00026199,277,7,14,79,100,0.36101083032490977
E00026200,211,7,7,50,64,0.3033175355450237
E00026201,216,2,5,27,34,0.1574074074074074
E00026202,261,9,12,61,82,0.31417624521072796
E00026203,213,3,2,56,61,0.2863849765258216
E00026204,309,7,68,99,174,0.5631067961165048
E00026205,238,13,9,63,85,0.35714285714285715
E00026206,218,3,6,48,57,0.26146788990825687
E00026207,233,3,3,65,71,0.30472103004291845
E00026208,408,13,14,82,109,0.26715686274509803
E00026209,265,11,13,71,95,0.3584905660377358
E00026210,189,4,6,38,48,0.25396825396825395
E00026211,237,5,10,60,75,0.31645569620253167
E00026212,277,7,13,63,83,0.2996389891696751
E00026213,215,5,11,62,78,0.3627906976744186
E00026214,184,4,7,78,89,0.483695652173913
E00026215,205,5,8,38,51,0.24878048780487805
E00026216,233,4,7,48,59,0.2532188841201717
E00026217,208,4,4,51,59,0.28365384615384615
E00026218,232,15,13,98,126,0.5431034482758621
E00026219,245,23,31,93,147,0.6
E00026220,239,12,5,60,77,0.32217573221757323
E00026221,213,14,8,94,116,0.5446009389671361
E00026222,389,30,30,96,156,0.40102827763496146
E00026223,314,28,15,115,158,0.5031847133757962
E00026224,354,30,17,142,189,0.5338983050847458
E00026225,402,30,25,214,269,0.6691542288557214
E00026226,377,12,69,185,266,0.7055702917771883
E00026227,176,13,5,88,106,0.6022727272727273
E00026228,325,6,45,142,193,0.5938461538461538
E00026230,287,8,15,97,120,0.4181184668989547
E00026231,200,14,8,73,95,0.475
E00026232,183,9,10,44,63,0.3442622950819672
E00026233,299,16,17,115,148,0.49498327759197325
E00026234,285,23,20,100,143,0.5017543859649123
E00026235,435,21,50,206,277,0.6367816091954023
E00026236,151,11,7,67,85,0.5629139072847682
E00026237,211,13,8,51,72,0.3412322274881517
E00026238,333,11,11,127,149,0.44744744744744747
E00026239,428,32,45,146,223,0.5210280373831776
E00026241,301,28,29,131,188,0.6245847176079734
E00026242,281,18,15,120,153,0.5444839857651246
E00026243,306,16,15,125,156,0.5098039215686274
E00026244,155,8,7,71,86,0.5548387096774193
E00026245,413,20,36,122,178,0.43099273607748184
E00026246,297,22,20,105,147,0.494949494949495
E00026247,233,19,8,78,105,0.45064377682403434
E00026248,414,15,38,127,180,0.43478260869565216
E00026250,218,24,12,91,127,0.5825688073394495
E00026251,570,5,186,343,534,0.9368421052631579
E00026252,434,14,21,93,128,0.29493087557603687
E00026253,538,3,202,289,494,0.9182156133828996
E00026254,191,18,10,77,105,0.5497382198952879
E00026255,268,6,43,96,145,0.5410447761194029
E00026256,292,33,14,75,122,0.4178082191780822
E00026257,229,27,6,84,117,0.5109170305676856
E00026258,176,11,6,98,115,0.6534090909090909
E00026259,178,15,6,72,93,0.5224719101123596
E00026260,205,13,11,49,73,0.35609756097560974
E00026261,216,15,5,79,99,0.4583333333333333
E00026262,155,16,7,60,83,0.535483870967742
E00026263,242,16,11,84,111,0.45867768595041325
E00026264,204,20,4,88,112,0.5490196078431373
E00026265,182,9,7,77,93,0.510989010989011
E00026266,225,19,10,66,95,0.4222222222222222
E00026267,215,7,7,70,84,0.39069767441860465
E00026268,233,23,15,65,103,0.44206008583690987
E00026269,252,22,12,81,115,0.45634920634920634
E00026270,252,21,12,103,136,0.5396825396825397
E00026272,225,13,7,75,95,0.4222222222222222
E00026273,202,4,3,64,71,0.35148514851485146
E00026274,289,26,9,94,129,0.4463667820069204
E00026275,283,10,8,83,101,0.3568904593639576
E00026276,246,22,12,89,123,0.5
E00026277,238,22,15,72,109,0.4579831932773109
E00026278,210,21,12,99,132,0.6285714285714286
E00026279,201,19,3,106,128,0.6368159203980099
E00026280,120,23,6,40,69,0.575
E00026281,189,17,2,72,91,0.48148148148148145
E00026282,260,26,10,98,134,0.5153846153846153
E00026283,252,16,3,122,141,0.5595238095238095
E00026284,225,13,14,90,117,0.52
E00026285,194,24,6,65,95,0.4896907216494845
E00026286,196,23,4,79,106,0.5408163265306123
E00026287,221,16,4,95,115,0.5203619909502263
E00026288,306,19,14,95,128,0.41830065359477125
E00026289,193,8,6,77,91,0.47150259067357514
E00026290,197,10,6,90,106,0.5380710659898477
E00026291,249,23,10,84,117,0.46987951807228917
E00026292,208,7,7,64,78,0.375
E00026293,220,12,8,59,79,0.35909090909090907
E00026294,261,24,11,107,142,0.5440613026819924
E00026295,213,17,8,53,78,0.36619718309859156
E00026296,216,19,8,78,105,0.4861111111111111
E00026297,183,4,4,45,53,0.2896174863387978
E00026298,291,15,6,58,79,0.27147766323024053
E00026299,250,28,10,54,92,0.368
E00026300,199,13,9,67,89,0.4472361809045226
E00026301,283,7,8,91,106,0.3745583038869258
E00026302,249,24,13,107,144,0.5783132530120482
E00026303,286,27,17,127,171,0.5979020979020979
E00026304,242,21,7,101,129,0.5330578512396694
E00026305,243,19,11,102,132,0.5432098765432098
E00026306,296,28,12,115,155,0.5236486486486487
E00026307,309,31,19,94,144,0.46601941747572817
E00026308,282,31,21,96,148,0.524822695035461
E00026309,178,20,10,67,97,0.5449438202247191
E00026310,332,21,15,112,148,0.4457831325301205
E00026312,310,28,29,127,184,0.5935483870967742
E00026313,216,11,5,57,73,0.33796296296296297
E00026314,290,13,20,95,128,0.4413793103448276
E00026315,420,34,28,142,204,0.4857142857142857
E00026316,306,23,17,118,158,0.5163398692810458
E00026317,244,27,8,105,140,0.5737704918032787
E00026318,160,11,6,68,85,0.53125
E00026319,234,11,10,64,85,0.36324786324786323
E00026320,229,2,3,51,56,0.2445414847161572
E00026321,223,20,14,94,128,0.5739910313901345
E00026322,179,10,2,84,96,0.5363128491620112
E00026323,275,42,17,93,152,0.5527272727272727
E00026324,205,17,4,95,116,0.5658536585365853
E00026325,263,37,12,114,163,0.6197718631178707
E00026326,238,22,9,72,103,0.4327731092436975
E00026327,178,10,4,62,76,0.42696629213483145
E00026328,275,28,18,103,149,0.5418181818181819
E00026329,260,24,12,108,144,0.5538461538461539
E00026330,209,8,14,93,115,0.5502392344497608
E00026331,238,22,9,81,112,0.47058823529411764
E00026332,205,18,5,104,127,0.6195121951219512
E00026333,235,33,14,81,128,0.5446808510638298
E00026334,316,30,10,107,147,0.4651898734177215
E00026335,249,19,11,62,92,0.36947791164658633
E00026336,178,18,5,95,118,0.6629213483146067
E00026337,148,22,5,58,85,0.5743243243243243
E00026338,319,28,17,135,180,0.5642633228840125
E00026340,392,15,20,183,218,0.5561224489795918
E00026341,342,36,28,132,196,0.5730994152046783
E00026342,239,8,9,85,102,0.42677824267782427
E00026343,243,27,11,80,118,0.48559670781893005
E00026344,306,37,14,140,191,0.6241830065359477
E00026345,280,32,8,159,199,0.7107142857142857
E00026346,242,18,20,77,115,0.47520661157024796
E00026348,298,25,28,109,162,0.5436241610738255
E00026349,297,33,12,167,212,0.7138047138047138
E00026350,229,9,6,70,85,0.37117903930131
E00026351,183,8,8,80,96,0.5245901639344263
E00026352,217,16,4,78,98,0.45161290322580644
E00026353,312,11,10,115,136,0.4358974358974359
E00026354,225,12,5,100,117,0.52
E00026355,305,30,10,85,125,0.4098360655737705
E00026356,169,12,1,95,108,0.6390532544378699
E00026357,196,18,10,90,118,0.6020408163265306
E00026358,190,17,3,78,98,0.5157894736842106
E00026359,330,24,14,115,153,0.4636363636363636
E00026360,157,14,3,87,104,0.6624203821656051
E00026361,241,24,3,113,140,0.5809128630705395
E00026362,299,37,12,128,177,0.5919732441471572
E00026363,213,16,5,99,120,0.5633802816901409
E00026364,170,28,1,100,129,0.7588235294117647
E00026365,200,27,9,94,130,0.65
E00026366,232,17,2,127,146,0.6293103448275862
E00026367,173,10,7,96,113,0.653179190751445
E00026369,224,26,7,99,132,0.5892857142857143
E00026371,276,29,7,128,164,0.5942028985507246
E00026372,269,31,9,135,175,0.6505576208178439
E00026373,204,9,0,65,74,0.3627450980392157
E00026374,222,11,6,71,88,0.3963963963963964
E00026375,331,13,12,100,125,0.3776435045317221
E00026376,236,12,7,88,107,0.4533898305084746
E00026378,352,38,25,119,182,0.5170454545454546
E00026379,185,17,11,40,68,0.3675675675675676
E00026381,170,19,14,57,90,0.5294117647058824
E00026383,328,17,20,83,120,0.36585365853658536
E00026384,192,16,8,87,111,0.578125
E00026386,410,22,35,147,204,0.4975609756097561
E00026387,184,20,10,68,98,0.532608695652174
E00026390,1430,2,393,997,1392,0.9734265734265735
E00026392,191,15,8,80,103,0.5392670157068062
E00026393,159,11,16,37,64,0.4025157232704403
E00026395,231,24,15,118,157,0.6796536796536796
E00026396,95,7,0,13,20,0.21052631578947367
E00026397,269,20,17,112,149,0.5539033457249071
E00026398,176,14,9,82,105,0.5965909090909091
E00026400,190,10,10,36,56,0.29473684210526313
E00026401,268,10,16,129,155,0.5783582089552238
E00026402,237,21,13,113,147,0.620253164556962
E00026403,221,19,15,91,125,0.5656108597285068
E00026405,161,13,11,63,87,0.5403726708074534
E00026406,185,19,8,65,92,0.4972972972972973
E00026407,154,16,6,76,98,0.6363636363636364
E00026408,138,6,13,55,74,0.5362318840579711
E00026409,223,22,14,70,106,0.47533632286995514
E00026410,222,17,13,62,92,0.4144144144144144
E00026411,305,19,11,69,99,0.32459016393442625
E00026412,276,9,23,128,160,0.5797101449275363
E00026413,338,27,9,104,140,0.41420118343195267
E00026414,207,9,8,106,123,0.5942028985507246
E00026415,365,21,14,149,184,0.5041095890410959
E00026416,302,12,14,91,117,0.38741721854304634
E00026417,396,12,87,170,269,0.6792929292929293
E00026418,234,7,13,75,95,0.405982905982906
E00026419,261,21,17,77,115,0.44061302681992337
E00026420,267,9,11,97,117,0.43820224719101125
E00026421,213,10,28,91,129,0.6056338028169014
E00026422,208,7,7,90,104,0.5
E00026423,257,12,10,67,89,0.3463035019455253
E00026424,224,13,6,58,77,0.34375
E00026425,146,4,2,38,44,0.3013698630136986
E00026426,335,12,13,97,122,0.3641791044776119
E00026427,243,5,11,97,113,0.46502057613168724
E00026428,235,8,17,63,88,0.37446808510638296
E00026429,212,8,9,53,70,0.330188679245283
E00026430,262,21,17,86,124,0.4732824427480916
E00026431,258,6,8,72,86,0.3333333333333333
E00026432,250,5,15,93,113,0.452
E00026433,268,27,16,106,149,0.5559701492537313
E00026434,301,14,12,114,140,0.46511627906976744
E00026435,266,10,23,84,117,0.4398496240601504
E00026436,267,19,5,81,105,0.39325842696629215
E00026437,361,24,13,100,137,0.37950138504155123
E00026438,219,9,8,72,89,0.4063926940639269
E00026439,229,20,9,71,100,0.4366812227074236
E00026440,262,18,9,79,106,0.40458015267175573
E00026441,276,23,11,99,133,0.48188405797101447
E00026442,253,21,7,66,94,0.3715415019762846
E00026443,260,18,8,82,108,0.4153846153846154
E00026444,278,18,19,83,120,0.4316546762589928
E00026445,320,25,18,117,160,0.5
E00026446,356,29,29,123,181,0.5084269662921348
E00026447,275,18,14,74,106,0.38545454545454544
E00026448,315,31,22,102,155,0.49206349206349204
E00026449,292,14,21,83,118,0.4041095890410959
E00026450,240,13,17,94,124,0.5166666666666667
E00026451,229,16,10,80,106,0.462882096069869
E00026452,271,29,10,94,133,0.4907749077490775
E00026453,267,23,12,91,126,0.47191011235955055
E00026454,176,15,9,82,106,0.6022727272727273
E00026455,226,26,8,99,133,0.588495575221239
E00026457,205,21,14,63,98,0.47804878048780486
E00026458,251,10,10,73,93,0.3705179282868526
E00026459,242,11,6,85,102,0.4214876033057851
E00026460,155,8,3,60,71,0.45806451612903226
E00026461,351,20,23,91,134,0.3817663817663818
E00026462,171,10,4,71,85,0.49707602339181284
E00026463,322,23,10,74,107,0.33229813664596275
E00026464,224,21,5,83,109,0.48660714285714285
E00026465,210,13,9,84,106,0.5047619047619047
E00026466,291,34,12,120,166,0.570446735395189
E00026467,186,19,3,86,108,0.5806451612903226
E00026468,223,9,2,79,90,0.40358744394618834
E00026469,228,12,2,78,92,0.40350877192982454
E00026470,260,14,7,73,94,0.36153846153846153
E00026471,189,9,6,90,105,0.5555555555555556
E00026472,293,29,19,99,147,0.5017064846416383
E00026473,141,6,13,50,69,0.48936170212765956
E00026474,230,27,6,117,150,0.6521739130434783
E00026475,177,22,10,70,102,0.576271186440678
E00026476,240,18,6,109,133,0.5541666666666667
E00026477,275,24,10,87,121,0.44
E00026478,183,24,9,77,110,0.6010928961748634
E00026479,169,28,3,94,125,0.7396449704142012
E00026480,214,14,7,49,70,0.32710280373831774
E00026481,229,5,13,66,84,0.36681222707423583
E00026482,254,10,1,51,62,0.2440944881889764
E00026483,223,7,3,60,70,0.31390134529147984
E00026484,236,27,5,64,96,0.4067796610169492
E00026485,240,10,11,65,86,0.35833333333333334
E00026487,206,12,4,55,71,0.3446601941747573
E00026488,200,17,4,51,72,0.36
E00026489,238,18,11,93,122,0.5126050420168067
E00026490,200,21,14,83,118,0.59
E00026491,291,25,20,117,162,0.5567010309278351
E00026492,223,20,18,99,137,0.6143497757847534
E00026493,487,15,98,219,332,0.6817248459958932
E00026494,385,31,32,200,263,0.6831168831168831
E00026495,342,19,31,172,222,0.6491228070175439
E00026496,359,33,29,155,217,0.6044568245125348
E00026497,186,23,14,79,116,0.6236559139784946
E00026498,253,31,20,111,162,0.6403162055335968
E00026501,238,30,14,113,157,0.6596638655462185
E00026502,268,20,32,106,158,0.5895522388059702
E00026503,289,21,16,132,169,0.5847750865051903
E00026504,387,23,51,190,264,0.6821705426356589
E00026505,296,29,42,125,196,0.6621621621621622
E00026506,323,29,30,137,196,0.6068111455108359
E00026507,339,28,22,132,182,0.5368731563421829
E00026508,278,22,23,108,153,0.5503597122302158
E00026509,306,29,19,120,168,0.5490196078431373
E00026510,397,15,103,205,323,0.8136020151133502
E00026511,275,17,29,105,151,0.5490909090909091
E00026512,302,26,30,122,178,0.5894039735099338
E00026513,343,27,27,161,215,0.6268221574344023
E00026514,396,32,50,178,260,0.6565656565656566
E00026515,308,20,19,140,179,0.5811688311688312
E00026516,345,19,19,165,203,0.5884057971014492
E00026517,334,19,31,143,193,0.5778443113772455
E00026518,351,29,33,139,201,0.5726495726495726
E00026519,429,33,45,206,284,0.662004662004662
E00026520,380,19,35,174,228,0.6
E00026521,339,26,18,137,181,0.5339233038348082
E00026522,355,19,23,145,187,0.5267605633802817
E00026523,334,16,30,167,213,0.6377245508982036
E00026524,217,21,19,85,125,0.576036866359447
E00026525,252,20,14,115,149,0.5912698412698413
E00026526,224,20,14,62,96,0.42857142857142855
E00026527,215,17,4,112,133,0.6186046511627907
E00026528,219,20,8,93,121,0.5525114155251142
E00026529,126,16,11,48,75,0.5952380952380952
E00026530,369,9,96,201,306,0.8292682926829268
E00026531,311,32,28,148,208,0.6688102893890675
E00026532,236,21,20,99,140,0.5932203389830508
E00026533,517,12,154,247,413,0.7988394584139265
E00026534,330,20,54,151,225,0.6818181818181818
E00026535,305,26,17,157,200,0.6557377049180327
E00026536,289,20,33,140,193,0.6678200692041523
E00026537,289,18,29,76,123,0.42560553633217996
E00026539,259,27,14,114,155,0.5984555984555985
E00026540,215,31,8,109,148,0.6883720930232559
E00026541,287,33,17,113,163,0.5679442508710801
E00026542,242,29,16,106,151,0.6239669421487604
E00026543,253,33,16,100,149,0.5889328063241107
E00026544,333,22,46,150,218,0.6546546546546547
E00026545,300,24,36,123,183,0.61
E00026546,283,26,22,95,143,0.5053003533568905
E00026547,288,30,14,126,170,0.5902777777777778
E00026548,286,31,24,118,173,0.6048951048951049
E00026549,363,24,23,117,164,0.45179063360881544
E00026550,366,27,52,114,193,0.5273224043715847
E00026551,415,27,43,103,173,0.41686746987951806
E00026552,203,33,8,63,104,0.5123152709359606
E00026553,333,29,36,125,190,0.5705705705705706
E00026554,274,29,16,80,125,0.4562043795620438
E00026555,316,21,58,102,181,0.5727848101265823
E00026556,286,14,31,95,140,0.48951048951048953
E00026557,239,12,13,114,139,0.5815899581589958
E00026558,281,22,17,102,141,0.501779359430605
E00026559,319,27,24,147,198,0.6206896551724138
E00026561,242,18,9,120,147,0.6074380165289256
E00026563,230,22,16,118,156,0.6782608695652174
E00026564,243,22,30,105,157,0.6460905349794238
E00026565,204,18,14,104,136,0.6666666666666666
E00026566,425,23,77,208,308,0.7247058823529412
E00026567,338,27,66,149,242,0.7159763313609467
E00026568,431,26,75,199,300,0.6960556844547564
E00026569,297,40,17,129,186,0.6262626262626263
E00026570,267,33,15,117,165,0.6179775280898876
E00026571,209,15,7,92,114,0.5454545454545454
E00026572,247,31,16,108,155,0.6275303643724697
E00026573,224,26,16,92,134,0.5982142857142857
E00026574,203,26,11,101,138,0.6798029556650246
E00026575,235,19,6,63,88,0.37446808510638296
E00026576,245,4,6,80,90,0.3673469387755102
E00026577,255,11,11,79,101,0.396078431372549
E00026578,247,22,12,100,134,0.5425101214574899
E00026579,249,20,11,95,126,0.5060240963855421
E00026580,231,20,11,85,116,0.5021645021645021
E00026581,214,11,0,86,97,0.4532710280373832
E00026582,187,6,5,81,92,0.4919786096256685
E00026583,98,7,2,49,58,0.5918367346938775
E00026584,244,17,5,90,112,0.45901639344262296
E00026585,247,15,11,82,108,0.43724696356275305
E00026586,305,36,7,100,143,0.46885245901639344
E00026587,255,16,9,88,113,0.44313725490196076
E00026588,235,25,12,83,120,0.5106382978723404
E00026589,210,11,7,92,110,0.5238095238095238
E00026590,235,9,3,79,91,0.3872340425531915
E00026591,279,7,11,76,94,0.33691756272401435
E00026592,259,13,13,83,109,0.42084942084942084
E00026593,279,16,5,73,94,0.33691756272401435
E00026594,231,13,7,82,102,0.44155844155844154
E00026595,220,19,6,70,95,0.4318181818181818
E00026596,235,7,10,69,86,0.3659574468085106
E00026597,208,7,5,57,69,0.3317307692307692
E00026598,188,22,3,81,106,0.5638297872340425
E00026599,243,20,8,92,120,0.49382716049382713
E00026600,230,8,9,61,78,0.3391304347826087
E00026601,212,10,4,75,89,0.419811320754717
E00026602,228,11,7,68,86,0.37719298245614036
E00026603,232,10,1,90,101,0.4353448275862069
E00026604,223,14,3,46,63,0.2825112107623318
E00026605,207,20,7,71,98,0.47342995169082125
E00026606,175,20,6,77,103,0.5885714285714285
E00026607,338,14,9,111,134,0.39644970414201186
E00026608,214,5,7,60,72,0.3364485981308411
E00026609,208,6,6,83,95,0.4567307692307692
E00026610,193,1,4,94,99,0.5129533678756477
E00026611,228,7,4,58,69,0.3026315789473684
E00026612,357,25,7,83,115,0.32212885154061627
E00026613,216,7,5,63,75,0.3472222222222222
E00026614,213,19,12,75,106,0.49765258215962443
E00026615,224,12,6,70,88,0.39285714285714285
E00026616,215,21,4,107,132,0.6139534883720931
E00026617,214,13,9,97,119,0.5560747663551402
E00026618,218,8,0,51,59,0.2706422018348624
E00026619,195,23,3,98,124,0.6358974358974359
E00026620,214,19,7,88,114,0.5327102803738317
E00026621,213,12,5,69,86,0.40375586854460094
E00026622,170,27,9,71,107,0.6294117647058823
E00026623,231,13,8,74,95,0.41125541125541126
E00026624,253,17,5,118,140,0.5533596837944664
E00026625,219,5,7,72,84,0.3835616438356164
E00026626,189,14,8,79,101,0.5343915343915344
E00026627,214,20,13,87,120,0.5607476635514018
E00026628,237,13,8,86,107,0.45147679324894513
E00026629,215,21,7,104,132,0.6139534883720931
E00026630,208,17,4,90,111,0.5336538461538461
E00026631,173,12,6,81,99,0.5722543352601156
E00026632,166,13,1,114,128,0.7710843373493976
E00026633,355,23,13,142,178,0.5014084507042254
E00026634,242,19,11,128,158,0.6528925619834711
E00026635,222,19,2,84,105,0.47297297297297297
E00026636,242,11,8,72,91,0.3760330578512397
E00026637,376,31,20,150,201,0.5345744680851063
E00026638,176,8,1,100,109,0.6193181818181818
E00026639,268,28,4,91,123,0.458955223880597
E00026640,209,8,7,90,105,0.5023923444976076
E00026641,173,14,6,71,91,0.5260115606936416
E00026642,241,17,5,74,96,0.3983402489626556
E00026643,214,17,9,69,95,0.4439252336448598
E00026644,223,25,6,83,114,0.5112107623318386
E00026645,208,16,7,93,116,0.5576923076923077
E00026646,236,22,11,88,121,0.5127118644067796
E00026647,190,12,2,97,111,0.5842105263157895
E00026648,180,20,4,73,97,0.5388888888888889
E00026649,187,14,3,72,89,0.47593582887700536
E00026650,192,18,5,87,110,0.5729166666666666
E00026651,183,18,3,72,93,0.5081967213114754
E00026652,215,30,7,106,143,0.6651162790697674
E00026653,255,21,6,87,114,0.4470588235294118
E00026654,173,9,3,82,94,0.5433526011560693
E00026655,214,12,7,81,100,0.4672897196261682
E00026656,416,13,9,47,69,0.1658653846153846
E00026657,112,12,4,33,49,0.4375
E00026658,149,17,3,52,72,0.48322147651006714
E00026659,172,19,5,59,83,0.48255813953488375
E00026660,295,12,11,100,123,0.41694915254237286
E00026661,227,10,1,69,80,0.3524229074889868
E00026662,219,22,4,75,101,0.4611872146118721
E00026663,239,2,6,57,65,0.2719665271966527
E00026664,212,12,8,85,105,0.49528301886792453
E00026665,219,6,1,35,42,0.1917808219178082
E00026666,179,11,2,68,81,0.45251396648044695
E00026667,228,8,7,72,87,0.3815789473684211
E00026668,258,20,5,96,121,0.4689922480620155
E00026669,383,36,14,107,157,0.40992167101827676
E00026670,244,21,8,81,110,0.45081967213114754
E00026671,221,14,5,65,84,0.38009049773755654
E00026672,232,15,12,49,76,0.3275862068965517
E00026673,220,12,5,34,51,0.2318181818181818
E00026674,264,16,9,74,99,0.375
E00026675,228,7,8,72,87,0.3815789473684211
E00026676,182,7,5,57,69,0.3791208791208791
E00026677,234,12,5,85,102,0.4358974358974359
E00026678,228,6,6,33,45,0.19736842105263158
E00026679,278,8,7,92,107,0.38489208633093525
E00026680,203,12,9,55,76,0.37438423645320196
E00026681,149,5,3,64,72,0.48322147651006714
E00026682,234,9,4,29,42,0.1794871794871795
E00026683,227,15,10,51,76,0.33480176211453744
E00026684,284,11,4,64,79,0.27816901408450706
E00026685,193,8,3,57,68,0.35233160621761656
E00026686,157,13,0,70,83,0.5286624203821656
E00026687,189,7,4,88,99,0.5238095238095238
E00026688,217,5,9,53,67,0.3087557603686636
E00026689,327,9,4,63,76,0.2324159021406728
E00026690,201,18,3,62,83,0.4129353233830846
E00026691,200,2,10,45,57,0.285
E00026692,244,7,3,74,84,0.3442622950819672
E00026693,185,18,6,60,84,0.4540540540540541
E00026694,159,12,0,70,82,0.5157232704402516
E00026695,204,9,8,67,84,0.4117647058823529
E00026696,208,14,3,73,90,0.4326923076923077
E00026697,226,17,5,91,113,0.5
E00026698,220,15,4,70,89,0.40454545454545454
E00026699,221,20,9,79,108,0.48868778280542985
E00026700,255,11,17,57,85,0.3333333333333333
E00026701,365,17,16,69,102,0.27945205479452057
E00026702,376,8,103,201,312,0.8297872340425532
E00026703,382,12,65,185,262,0.6858638743455497
E00026704,262,31,14,101,146,0.5572519083969466
E00026705,272,28,22,92,142,0.5220588235294118
E00026706,213,15,4,84,103,0.4835680751173709
E00026707,242,19,7,77,103,0.4256198347107438
E00026708,278,15,21,92,128,0.460431654676259
E00026709,300,13,44,68,125,0.4166666666666667
E00026710,288,16,34,94,144,0.5
E00026711,192,17,24,59,100,0.5208333333333334
E00026712,226,6,13,34,53,0.2345132743362832
E00026713,308,6,18,62,86,0.2792207792207792
E00026714,229,10,15,37,62,0.27074235807860264
E00026715,280,8,18,71,97,0.3464285714285714
E00026716,225,6,25,48,79,0.3511111111111111
E00026717,223,5,7,52,64,0.28699551569506726
E00026718,329,6,15,44,65,0.19756838905775076
E00026719,206,6,9,33,48,0.23300970873786409
E00026720,296,5,8,59,72,0.24324324324324326
E00026721,346,20,13,53,86,0.24855491329479767
E00026722,379,18,69,196,283,0.7467018469656992
E00026723,388,22,86,189,297,0.7654639175257731
E00026724,363,23,43,155,221,0.6088154269972452
E00026725,198,17,5,71,93,0.4696969696969697
E00026726,542,8,144,326,478,0.8819188191881919
E00026727,230,14,13,84,111,0.4826086956521739
E00026728,423,6,87,234,327,0.7730496453900709
E00026730,325,33,50,121,204,0.6276923076923077
E00026731,228,21,10,79,110,0.4824561403508772
E00026732,265,8,43,123,174,0.6566037735849056
E00026733,213,15,4,81,100,0.4694835680751174
E00026734,428,5,78,223,306,0.7149532710280374
E00026735,273,20,26,86,132,0.4835164835164835
E00026736,270,15,14,75,104,0.3851851851851852
E00026737,224,11,13,86,110,0.49107142857142855
E00026738,446,6,71,239,316,0.7085201793721974
E00026739,215,13,14,82,109,0.5069767441860465
E00026740,274,9,41,110,160,0.583941605839416
E00026741,264,12,34,143,189,0.7159090909090909
E00026742,238,15,11,82,108,0.453781512605042
E00026743,226,20,7,89,116,0.5132743362831859
E00026744,172,14,2,61,77,0.4476744186046512
E00026745,227,19,8,82,109,0.4801762114537445
E00026746,292,15,20,112,147,0.5034246575342466
E00026747,227,16,4,67,87,0.3832599118942731
E00026748,438,18,66,209,293,0.6689497716894978
E00026749,168,16,6,94,116,0.6904761904761905
E00026750,322,23,25,154,202,0.6273291925465838
E00026751,339,19,17,146,182,0.5368731563421829
E00026752,291,6,39,125,170,0.584192439862543
E00026753,313,23,24,132,179,0.5718849840255591
E00026754,339,17,21,142,180,0.5309734513274337
E00026755,289,14,20,114,148,0.5121107266435986
E00026756,404,20,60,235,315,0.7797029702970297
E00026758,602,6,197,363,566,0.9401993355481728
E00026759,286,8,63,157,228,0.7972027972027972
E00026760,536,12,181,299,492,0.917910447761194
E00026761,174,3,28,68,99,0.5689655172413793
E00026764,456,10,75,245,330,0.7236842105263158
E00026765,400,32,37,220,289,0.7225
E00026766,453,14,91,211,316,0.6975717439293598
E00026767,322,20,29,157,206,0.639751552795031
E00026768,290,7,41,130,178,0.6137931034482759
E00026769,278,16,37,138,191,0.6870503597122302
E00026770,357,25,28,171,224,0.6274509803921569
E00026771,225,22,22,109,153,0.68
E00026772,350,12,64,156,232,0.6628571428571428
E00026773,279,9,23,91,123,0.44086021505376344
E00026774,247,20,12,126,158,0.6396761133603239
E00026775,368,18,38,186,242,0.657608695652174
E00026776,97,10,0,62,72,0.7422680412371134
E00026777,200,13,14,91,118,0.59
E00026778,263,17,27,141,185,0.7034220532319392
E00026779,266,30,14,136,180,0.6766917293233082
E00026780,365,13,70,153,236,0.6465753424657534
E00026781,379,9,65,180,254,0.6701846965699209
E00026782,345,16,47,147,210,0.6086956521739131
E00026783,325,20,13,168,201,0.6184615384615385
E00026784,329,23,19,148,190,0.5775075987841946
E00026785,266,20,5,76,101,0.37969924812030076
E00026786,180,11,9,77,97,0.5388888888888889
E00026787,267,23,12,88,123,0.4606741573033708
E00026788,190,13,1,69,83,0.4368421052631579
E00026789,200,3,1,33,37,0.185
E00026790,227,9,6,49,64,0.28193832599118945
E00026791,198,17,6,66,89,0.4494949494949495
E00026792,215,20,1,102,123,0.5720930232558139
E00026793,224,20,13,81,114,0.5089285714285714
E00026795,220,9,5,72,86,0.39090909090909093
E00026796,219,13,8,72,93,0.4246575342465753
E00026797,231,14,8,58,80,0.3463203463203463
E00026798,214,23,10,75,108,0.5046728971962616
E00026799,127,9,0,81,90,0.7086614173228346
E00026800,250,5,7,73,85,0.34
E00026801,220,3,10,87,100,0.45454545454545453
E00026802,264,13,8,48,69,0.26136363636363635
E00026803,237,5,8,72,85,0.35864978902953587
E00026804,242,15,13,61,89,0.3677685950413223
E00026806,366,10,10,41,61,0.16666666666666666
E00026807,211,11,6,53,70,0.33175355450236965
E00026808,186,17,3,56,76,0.40860215053763443
E00026809,197,5,6,42,53,0.26903553299492383
E00026810,157,9,1,78,88,0.5605095541401274
E00026811,209,16,9,97,122,0.583732057416268
E00026812,223,15,6,85,106,0.47533632286995514
E00026813,232,19,9,79,107,0.46120689655172414
E00026814,205,19,5,72,96,0.4682926829268293
E00026815,236,23,11,91,125,0.5296610169491526
E00026816,259,21,11,106,138,0.5328185328185329
E00026817,220,21,6,86,113,0.5136363636363637
E00026818,234,29,2,76,107,0.45726495726495725
E00026819,211,11,5,66,82,0.3886255924170616
E00026821,296,9,11,114,134,0.4527027027027027
E00026822,315,20,19,127,166,0.526984126984127
E00026823,316,15,9,101,125,0.39556962025316456
E00026824,265,17,9,98,124,0.4679245283018868
E00026825,208,15,7,51,73,0.35096153846153844
E00026826,258,13,15,99,127,0.49224806201550386
E00026827,263,13,13,92,118,0.44866920152091255
E00026828,273,6,10,106,122,0.4468864468864469
E00026829,235,7,6,78,91,0.3872340425531915
E00026830,284,11,8,72,91,0.3204225352112676
E00026831,227,13,8,44,65,0.28634361233480177
E00026832,310,12,8,80,100,0.3225806451612903
E00026833,384,22,14,94,130,0.3385416666666667
E00026834,270,15,8,82,105,0.3888888888888889
E00026835,266,23,16,47,86,0.3233082706766917
E00026837,209,6,26,48,80,0.3827751196172249
E00026838,210,8,7,32,47,0.22380952380952382
E00026840,161,6,4,30,40,0.2484472049689441
E00026841,280,17,19,68,104,0.37142857142857144
E00026842,309,10,8,71,89,0.28802588996763756
E00026843,277,8,22,54,84,0.30324909747292417
E00026844,246,11,7,60,78,0.3170731707317073
E00026845,347,25,15,82,122,0.3515850144092219
E00026846,227,8,7,68,83,0.3656387665198238
E00026847,251,10,7,64,81,0.32270916334661354
E00026848,293,15,23,91,129,0.4402730375426621
E00026849,304,9,10,96,115,0.3782894736842105
E00026850,364,30,11,95,136,0.37362637362637363
E00026851,314,12,20,79,111,0.3535031847133758
E00026852,278,8,22,92,122,0.43884892086330934
E00026854,397,42,16,118,176,0.4433249370277078
E00026855,247,11,8,62,81,0.32793522267206476
E00026856,240,5,10,30,45,0.1875
E00026857,287,11,14,57,82,0.2857142857142857
E00026858,294,19,19,94,132,0.4489795918367347
E00026859,70,2,3,27,32,0.45714285714285713
E00026860,224,11,5,92,108,0.48214285714285715
E00026861,281,15,29,117,161,0.5729537366548043
E00026862,337,7,42,120,169,0.5014836795252225
E00026863,324,8,40,126,174,0.5370370370370371
E00026864,293,8,28,113,149,0.5085324232081911
E00026865,339,11,32,132,175,0.5162241887905604
E00026866,318,9,49,122,180,0.5660377358490566
E00026867,310,11,61,144,216,0.6967741935483871
E00026868,188,4,23,95,122,0.648936170212766
E00026869,222,11,30,61,102,0.4594594594594595
E00026870,357,13,65,182,260,0.7282913165266106
E00026871,368,9,64,141,214,0.5815217391304348
E00026872,319,7,42,146,195,0.6112852664576802
E00026873,336,12,51,149,212,0.6309523809523809
E00026874,316,11,43,115,169,0.5348101265822784
E00026875,278,7,57,120,184,0.6618705035971223
E00026876,348,15,38,138,191,0.5488505747126436
E00026877,477,28,40,142,210,0.44025157232704404
E00026878,456,5,58,177,240,0.5263157894736842
E00026879,361,14,43,140,197,0.5457063711911357
E00026880,339,11,30,109,150,0.4424778761061947
E00026881,275,10,18,79,107,0.3890909090909091
E00026882,231,4,24,74,102,0.44155844155844154
E00026883,259,13,21,98,132,0.5096525096525096
E00026884,238,29,9,79,117,0.49159663865546216
E00026885,241,8,14,67,89,0.36929460580912865
E00026886,210,7,8,44,59,0.28095238095238095
E00026887,198,18,12,78,108,0.5454545454545454
E00026888,258,10,15,60,85,0.32945736434108525
E00026889,300,4,10,82,96,0.32
E00026890,263,4,4,57,65,0.24714828897338403
E00026891,175,6,2,40,48,0.2742857142857143
E00026892,264,9,44,119,172,0.6515151515151515
E00026893,485,5,111,241,357,0.7360824742268042
E00026894,475,3,123,311,437,0.92
E00026895,227,14,33,85,132,0.5814977973568282
E00026896,196,12,8,91,111,0.5663265306122449
E00026897,437,6,121,275,402,0.919908466819222
E00026898,374,24,84,169,277,0.7406417112299465
E00026899,291,11,75,147,233,0.8006872852233677
E00026900,362,7,74,209,290,0.8011049723756906
E00026901,372,13,97,204,314,0.8440860215053764
E00026902,341,14,52,158,224,0.656891495601173
E00026903,448,12,87,207,306,0.6830357142857143
E00026904,243,2,70,119,191,0.7860082304526749
E00026905,465,7,112,287,406,0.8731182795698925
E00026906,190,13,4,64,81,0.4263157894736842
E00026907,199,18,4,54,76,0.38190954773869346
E00026908,182,13,3,69,85,0.46703296703296704
E00026909,208,13,10,77,100,0.4807692307692308
E00026910,211,7,7,74,88,0.41706161137440756
E00026912,219,25,5,82,112,0.5114155251141552
E00026913,192,12,7,72,91,0.4739583333333333
E00026914,232,20,8,61,89,0.38362068965517243
E00026915,201,19,4,87,110,0.5472636815920398
E00026916,254,7,9,32,48,0.1889763779527559
E00026917,300,22,12,97,131,0.43666666666666665
E00026918,176,16,1,64,81,0.4602272727272727
E00026919,172,23,2,66,91,0.5290697674418605
E00026920,223,13,3,55,71,0.3183856502242152
E00026921,210,9,3,46,58,0.2761904761904762
E00026922,264,17,11,90,118,0.44696969696969696
E00026923,208,15,10,100,125,0.6009615384615384
E00026924,211,14,6,87,107,0.5071090047393365
E00026925,87,12,2,37,51,0.5862068965517241
E00026926,254,16,6,81,103,0.40551181102362205
E00026927,196,15,8,52,75,0.3826530612244898
E00026928,200,18,1,58,77,0.385
E00026929,202,8,10,84,102,0.504950495049505
E00026930,193,17,4,57,78,0.40414507772020725
E00026931,204,7,14,79,100,0.49019607843137253
E00026932,202,16,4,73,93,0.4603960396039604
E00026933,229,10,1,55,66,0.28820960698689957
E00026934,203,15,4,73,92,0.45320197044334976
E00026935,232,17,9,73,99,0.4267241379310345
E00026936,244,19,5,94,118,0.48360655737704916
E00026937,422,22,14,90,126,0.2985781990521327
E00026938,197,11,0,67,78,0.39593908629441626
E00026939,220,14,4,86,104,0.4727272727272727
E00026940,164,17,1,61,79,0.4817073170731707
E00026941,230,10,2,85,97,0.4217391304347826
E00026942,220,19,5,81,105,0.4772727272727273
E00026943,237,18,11,80,109,0.459915611814346
E00026944,77,1,3,23,27,0.35064935064935066
E00175804,287,7,26,47,80,0.2787456445993031
E00175805,477,11,79,336,426,0.8930817610062893
E00175806,1344,3,476,815,1294,0.9627976190476191
E00175807,423,12,65,242,319,0.7541371158392435
E00175808,985,8,234,677,919,0.932994923857868
E00175809,463,3,41,284,328,0.7084233261339092
E00175810,198,2,16,32,50,0.25252525252525254
E00175811,771,3,141,588,732,0.9494163424124513
E00175812,391,8,64,268,340,0.8695652173913043
E00175813,371,7,67,265,339,0.9137466307277629
E00175814,183,3,15,33,51,0.2786885245901639
E00175815,210,11,40,97,148,0.7047619047619048
E00175816,438,11,20,47,78,0.1780821917808219
E00175817,830,43,186,509,738,0.8891566265060241
E00175818,759,23,234,444,701,0.9235836627140975
E00175819,2050,2,574,1411,1987,0.9692682926829268
E00175820,839,7,211,564,782,0.932061978545888
E00175821,368,13,61,213,287,0.779891304347826
E00175822,199,12,14,45,71,0.35678391959798994
E00175823,188,6,25,20,51,0.2712765957446808
E00175824,377,10,61,237,308,0.8169761273209549
E00175825,992,4,152,804,960,0.967741935483871
E00175826,140,8,8,40,56,0.4
E00175827,293,7,16,146,169,0.5767918088737202
E00175828,230,8,23,61,92,0.4
E00175829,364,21,19,147,187,0.5137362637362637
E00175830,220,4,43,137,184,0.8363636363636363
E00175831,206,9,14,63,86,0.4174757281553398
E00175832,214,4,24,101,129,0.602803738317757
E00175833,212,24,12,84,120,0.5660377358490566
E00175834,216,21,19,98,138,0.6388888888888888
E00175835,917,11,189,624,824,0.8985823336968375
E00175836,207,12,15,50,77,0.3719806763285024
E00175837,363,17,19,155,191,0.5261707988980716
E00175838,233,20,10,81,111,0.47639484978540775
E00175839,185,12,9,87,108,0.5837837837837838
E00175840,228,1,21,19,41,0.17982456140350878
E00175841,190,7,18,59,84,0.4421052631578947
E00175842,145,4,1,114,119,0.8206896551724138
E00175843,160,5,23,45,73,0.45625
E00175844,224,26,6,89,121,0.5401785714285714
E00175845,155,8,9,26,43,0.27741935483870966
E00175846,175,7,20,21,48,0.2742857142857143
E00175847,129,7,1,76,84,0.6511627906976745
E00175848,251,20,13,87,120,0.47808764940239046
E00175849,194,10,15,71,96,0.4948453608247423
E00175850,189,17,7,78,102,0.5396825396825397
E00175851,175,2,16,27,45,0.2571428571428571
E00175852,305,3,29,82,114,0.3737704918032787
E00175853,189,2,10,60,72,0.38095238095238093
E00175854,182,7,22,27,56,0.3076923076923077
E00175855,216,3,4,16,23,0.10648148148148148
E00175856,152,5,8,7,20,0.13157894736842105
E00175857,131,12,9,30,51,0.3893129770992366
E00175858,132,8,3,65,76,0.5757575757575758
E00175859,152,19,4,28,51,0.3355263157894737
E00175860,260,15,11,40,66,0.25384615384615383
E00175861,170,10,10,38,58,0.3411764705882353
E00175862,156,7,3,59,69,0.4423076923076923
E00175863,185,3,20,43,66,0.3567567567567568
E00175864,238,8,17,28,53,0.22268907563025211
E00175865,199,2,9,14,25,0.12562814070351758
E00175866,169,3,10,28,41,0.24260355029585798
E00175867,161,4,6,17,27,0.16770186335403728
E00175868,126,4,10,16,30,0.23809523809523808
E00175869,211,8,18,58,84,0.3981042654028436
E00175870,162,5,8,21,34,0.20987654320987653
E00175871,229,4,16,21,41,0.17903930131004367
E00175872,243,6,16,33,55,0.22633744855967078
E00175873,213,5,17,19,41,0.19248826291079812
E00175874,167,7,16,18,41,0.24550898203592814
E00175875,463,1,109,323,433,0.9352051835853131
E00175876,186,11,8,53,72,0.3870967741935484
E00175877,198,8,25,28,61,0.30808080808080807
E00175878,246,27,7,110,144,0.5853658536585366
E00175879,169,9,7,27,43,0.25443786982248523
E00175880,112,5,4,28,37,0.33035714285714285
E00175881,235,12,4,52,68,0.28936170212765955
E00175882,183,10,5,66,81,0.4426229508196721
E00175883,161,7,6,33,46,0.2857142857142857
E00175884,211,3,2,18,23,0.10900473933649289
E00175885,280,0,5,19,24,0.08571428571428572
E00175886,185,1,5,24,30,0.16216216216216217
E00175887,176,3,4,13,20,0.11363636363636363
E00175888,250,5,5,25,35,0.14
E00175889,213,4,5,49,58,0.27230046948356806
E00175890,193,15,2,67,84,0.43523316062176165
E00175891,207,7,2,38,47,0.22705314009661837
E00175892,219,6,8,39,53,0.2420091324200913
E00175893,181,15,6,47,68,0.3756906077348066
E00175894,166,13,0,68,81,0.4879518072289157
E00175895,387,21,20,115,156,0.40310077519379844
E00175896,199,31,3,126,160,0.8040201005025126
E00175897,237,11,16,83,110,0.4641350210970464
E00175898,219,17,4,75,96,0.4383561643835616
E00175899,184,12,7,80,99,0.5380434782608695
E00175900,232,12,12,46,70,0.3017241379310345
E00175901,182,8,3,43,54,0.2967032967032967
E00175902,228,16,12,62,90,0.39473684210526316
E00175903,248,15,7,85,107,0.4314516129032258
E00175904,277,15,8,135,158,0.5703971119133574
E00175905,186,3,14,9,26,0.13978494623655913
E00175906,167,10,29,57,96,0.5748502994011976
E00175907,299,17,47,90,154,0.5150501672240803
E00175908,286,12,40,67,119,0.4160839160839161
E00175909,279,10,12,12,34,0.12186379928315412
E00175910,177,2,7,17,26,0.14689265536723164
E00175911,187,8,11,41,60,0.32085561497326204
E00175912,251,9,14,105,128,0.5099601593625498
E00175913,123,6,5,48,59,0.4796747967479675
E00175914,207,2,6,9,17,0.0821256038647343
E00175915,220,0,13,30,43,0.19545454545454546
E00175916,254,6,12,16,34,0.13385826771653545
E00175917,222,3,6,22,31,0.13963963963963963
E00175918,200,11,14,70,95,0.475
E00175919,206,20,18,60,98,0.47572815533980584
E00175920,249,8,25,68,101,0.40562248995983935
E00175921,158,7,13,35,55,0.34810126582278483
E00175922,175,15,17,48,80,0.45714285714285713
E00175923,139,12,3,58,73,0.5251798561151079
E00175924,195,14,13,55,82,0.4205128205128205
E00175925,234,19,10,108,137,0.5854700854700855
E00175926,211,11,11,36,58,0.27488151658767773
E00175927,258,18,9,104,131,0.5077519379844961
E00175928,235,16,57,123,196,0.8340425531914893
E00175929,407,12,106,235,353,0.8673218673218673
E00175930,115,5,14,44,63,0.5478260869565217
E00175931,124,7,23,56,86,0.6935483870967742
E00175932,213,12,26,94,132,0.6197183098591549
E00175933,102,13,7,35,55,0.5392156862745098
E00175934,262,7,15,41,63,0.24045801526717558
E00175935,237,15,10,59,84,0.35443037974683544
E00175936,140,5,5,67,77,0.55
E00175937,246,6,20,30,56,0.22764227642276422
E00175938,107,4,3,11,18,0.16822429906542055
E00175939,85,12,5,34,51,0.6
E00175940,250,14,17,98,129,0.516
E00175941,244,19,21,57,97,0.3975409836065574
E00175942,962,58,27,498,583,0.606029106029106
E00175943,278,11,21,127,159,0.5719424460431655
E00175944,253,15,19,103,137,0.541501976284585
E00175945,204,8,15,27,50,0.24509803921568626
E00175946,165,6,18,30,54,0.32727272727272727
E00175947,255,10,19,32,61,0.23921568627450981
E00175948,155,8,11,26,45,0.2903225806451613
E00175949,319,27,18,161,206,0.64576802507837
E00175950,228,15,13,72,100,0.43859649122807015
E00175951,250,18,18,44,80,0.32
E00175952,458,10,35,69,114,0.24890829694323144
E00175953,182,16,16,75,107,0.5879120879120879
E00175954,233,23,21,70,114,0.4892703862660944
E00175955,207,17,14,80,111,0.5362318840579711
E00175956,141,5,6,73,84,0.5957446808510638
E00175957,713,5,226,458,689,0.9663394109396914
E00175958,128,2,22,72,96,0.75
E00175959,288,3,136,99,238,0.8263888888888888
E00175960,206,3,18,62,83,0.4029126213592233
E00175961,183,4,14,58,76,0.41530054644808745
E00175962,189,5,14,73,92,0.48677248677248675
E00175963,143,0,8,61,69,0.4825174825174825
E00175964,153,3,4,41,48,0.3137254901960784
E00175965,206,6,4,35,45,0.21844660194174756
E00175966,238,16,7,81,104,0.4369747899159664
E00175967,221,11,19,64,94,0.4253393665158371
E00175968,230,16,19,93,128,0.5565217391304348
E00175969,130,12,4,61,77,0.5923076923076923
E00175970,152,17,5,78,100,0.6578947368421053
E00175971,213,14,11,32,57,0.2676056338028169
E00175972,680,6,116,457,579,0.8514705882352941
E00175973,151,10,12,22,44,0.2913907284768212
E00175974,187,11,6,44,61,0.32620320855614976
E00175975,191,11,12,51,74,0.387434554973822
E00175976,186,14,7,82,103,0.553763440860215
E00175977,155,8,4,29,41,0.2645161290322581
E00175978,202,5,4,20,29,0.14356435643564355
E00175979,150,6,1,11,18,0.12
E00175980,202,5,5,38,48,0.2376237623762376
E00175981,170,11,2,56,69,0.40588235294117647
E00175982,192,18,6,41,65,0.3385416666666667
E00175983,192,5,3,16,24,0.125
E00175984,200,8,4,33,45,0.225
E00175985,193,5,9,28,42,0.21761658031088082
E00175986,120,5,1,25,31,0.25833333333333336
E00175987,188,6,14,30,50,0.26595744680851063
E00175988,142,6,3,20,29,0.20422535211267606
E00175989,196,4,4,24,32,0.16326530612244897
E00175990,196,1,6,16,23,0.11734693877551021
E00175991,333,4,22,213,239,0.7177177177177178
E00175992,339,5,15,125,145,0.4277286135693215
E00175993,270,5,14,149,168,0.6222222222222222
E00175994,184,3,2,15,20,0.10869565217391304
E00175995,151,2,12,35,49,0.32450331125827814
E00175996,211,6,11,27,44,0.20853080568720378
E00175997,218,1,25,59,85,0.38990825688073394
E00175998,180,5,5,30,40,0.2222222222222222
E00175999,345,6,14,63,83,0.24057971014492754
E00176000,240,3,7,119,129,0.5375
E00176001,280,3,21,63,87,0.3107142857142857
E00176002,110,2,16,21,39,0.35454545454545455
E00176003,181,6,6,44,56,0.30939226519337015
E00176004,207,2,25,66,93,0.4492753623188406
E00176005,275,1,19,99,119,0.43272727272727274
E00176006,219,2,7,27,36,0.1643835616438356
E00176007,102,1,3,22,26,0.2549019607843137
E00176008,136,6,1,25,32,0.23529411764705882
E00176009,200,2,17,101,120,0.6
E00176010,217,1,12,84,97,0.4470046082949309
E00176011,182,8,4,35,47,0.25824175824175827
E00176012,279,10,5,36,51,0.1827956989247312
E00176013,153,4,6,22,32,0.20915032679738563
E00176014,156,5,3,25,33,0.21153846153846154
E00176015,199,10,4,74,88,0.44221105527638194
E00176016,94,6,5,28,39,0.4148936170212766
E00176017,139,4,5,16,25,0.17985611510791366
E00176018,321,5,65,204,274,0.8535825545171339
E00176019,303,11,54,144,209,0.6897689768976898
E00176020,353,17,77,180,274,0.7762039660056658
E00176021,382,3,63,189,255,0.6675392670157068
E00176022,229,15,22,120,157,0.6855895196506551
E00176023,172,12,11,73,96,0.5581395348837209
E00176024,155,1,8,7,16,0.1032258064516129
E00176025,142,2,4,9,15,0.1056338028169014
E00176026,164,12,6,85,103,0.6280487804878049
E00176027,969,17,424,472,913,0.9422084623323014
E00176028,134,15,14,55,84,0.6268656716417911
E00176029,226,2,18,34,54,0.23893805309734514
E00176030,1082,3,272,765,1040,0.9611829944547134
E00176031,171,15,8,82,105,0.6140350877192983
E00176032,264,11,25,39,75,0.2840909090909091
E00176033,254,17,7,53,77,0.3031496062992126
E00176034,417,11,46,54,111,0.26618705035971224
E00176035,197,2,17,15,34,0.17258883248730963
E00176036,186,10,8,81,99,0.532258064516129
E00176037,208,3,14,19,36,0.17307692307692307
E00176038,591,7,130,348,485,0.8206429780033841
E00176039,165,10,8,35,53,0.3212121212121212
E00176040,154,20,21,69,110,0.7142857142857143
E00176041,559,6,199,306,511,0.9141323792486583
E00176042,247,19,25,86,130,0.5263157894736842
E00176043,166,13,16,34,63,0.3795180722891566
E00176044,255,14,8,52,74,0.2901960784313726
E00176045,173,8,12,41,61,0.35260115606936415
E00176046,1176,6,549,605,1160,0.9863945578231292
E00176047,119,6,9,21,36,0.3025210084033613
E00176048,182,8,11,46,65,0.35714285714285715
E00176049,310,7,43,65,115,0.3709677419354839
E00176050,192,2,11,20,33,0.171875
E00176051,157,3,12,16,31,0.19745222929936307
E00176052,193,4,23,30,57,0.29533678756476683
E00176053,172,9,13,25,47,0.27325581395348836
E00176054,191,9,8,56,73,0.38219895287958117
E00176055,173,5,11,54,70,0.4046242774566474
E00176056,205,3,25,78,106,0.5170731707317073
E00176057,202,4,15,23,42,0.2079207920792079
E00176058,167,9,7,29,45,0.2694610778443114
E00176059,217,5,12,39,56,0.25806451612903225
E00176060,219,8,9,40,57,0.2602739726027397
E00176061,139,8,29,78,115,0.8273381294964028
E00176062,199,2,7,49,58,0.2914572864321608
E00176063,174,1,12,61,74,0.42528735632183906
E00176064,140,6,12,44,62,0.44285714285714284
E00176065,198,11,1,110,122,0.6161616161616161
E00176066,247,14,14,61,89,0.3603238866396761
E00176067,223,20,7,93,120,0.5381165919282511
E00176068,175,15,9,63,87,0.49714285714285716
E00176069,140,14,5,74,93,0.6642857142857143
E00176070,475,22,22,68,112,0.23578947368421052
E00176071,187,13,14,34,61,0.32620320855614976
E00176072,208,14,6,62,82,0.3942307692307692
E00176073,223,14,13,62,89,0.3991031390134529
E00176074,171,14,2,90,106,0.6198830409356725
E00176075,141,4,11,46,61,0.4326241134751773
E00176076,221,2,21,19,42,0.19004524886877827
E00176077,210,14,8,63,85,0.40476190476190477
E00176078,235,20,12,97,129,0.548936170212766
E00176079,283,8,21,38,67,0.23674911660777384
E00176080,216,3,22,23,48,0.2222222222222222
E00176081,108,5,16,36,57,0.5277777777777778
E00176082,959,1,362,563,926,0.9655891553701773
E00176083,251,9,9,39,57,0.22709163346613545
E00176084,132,3,4,20,27,0.20454545454545456
E00176085,82,0,3,34,37,0.45121951219512196
E00176086,159,3,5,15,23,0.14465408805031446
E00176087,193,6,5,9,20,0.10362694300518134
E00176088,272,7,8,20,35,0.12867647058823528
E00176089,156,5,14,22,41,0.26282051282051283
E00176090,236,14,27,113,154,0.652542372881356
E00176091,617,3,180,427,610,0.9886547811993517
E00176092,193,5,3,9,17,0.08808290155440414
E00176093,245,16,38,126,180,0.7346938775510204
NA,NA,NA,NA,NA,NA,NA
"In order to protect against disclosure of personal information, records have been swapped between different geographic areas. Some counts will be affected, particularly small counts at the lowest geographies.",NA,NA,NA,NA,NA,NA
